(12,20)
A A D A B B A A D A
A B D E B B A A D A
A A B E B B A A D A
A B B E D B A A D A
A B B E A B A A D A
A B B E A B A A D A
A C D A D B A A D A
C C A C C B A A D A
B E C A C B A A D A
C C E C B B A A D A
A A D A B B A A D A
A A D A B B A A D A