(20,20)
A A D A B A A D A B
A B D E B A A D A B
A A B E B A A D A B
A B B E D A A D A B
A B B E A A A D A B
A B B E A A A D A B
A C D A D A A D A B
C C A C C A A D A B
B E C A C A A D A B
C C E C B A A D A B
A A D A B A A D A B
A B D E B A A D A B
A A B E B A A D A B
A B B E D A A D A B
A B B E A A A D A B
A B B E A A A D A B
A C D A D A A D A B
C C A C C A A D A B
B E C A C A A D A B
C C E C B A A D A B